deriche	medley/deriche	medley/deriche/deriche.c	LARGE_DATASET
nussinov	medley/nussinov	medley/nussinov/nussinov.c	LARGE_DATASET
floyd-warshall	medley/floyd-warshall	medley/floyd-warshall/floyd-warshall.c	LARGE_DATASET
3mm	linear-algebra/kernels/3mm	linear-algebra/kernels/3mm/3mm.c	LARGE_DATASET
2mm	linear-algebra/kernels/2mm	linear-algebra/kernels/2mm/2mm.c	LARGE_DATASET
doitgen	linear-algebra/kernels/doitgen	linear-algebra/kernels/doitgen/doitgen.c	LARGE_DATASET
bicg	linear-algebra/kernels/bicg	linear-algebra/kernels/bicg/bicg.c	LARGE_DATASET
atax	linear-algebra/kernels/atax	linear-algebra/kernels/atax/atax.c	LARGE_DATASET
mvt	linear-algebra/kernels/mvt	linear-algebra/kernels/mvt/mvt.c	LARGE_DATASET
gesummv	linear-algebra/blas/gesummv	linear-algebra/blas/gesummv/gesummv.c	LARGE_DATASET
symm	linear-algebra/blas/symm	linear-algebra/blas/symm/symm.c	LARGE_DATASET
trmm	linear-algebra/blas/trmm	linear-algebra/blas/trmm/trmm.c	LARGE_DATASET
gemm	linear-algebra/blas/gemm	linear-algebra/blas/gemm/gemm.c	LARGE_DATASET
syrk	linear-algebra/blas/syrk	linear-algebra/blas/syrk/syrk.c	LARGE_DATASET
syr2k	linear-algebra/blas/syr2k	linear-algebra/blas/syr2k/syr2k.c	LARGE_DATASET
gemver	linear-algebra/blas/gemver	linear-algebra/blas/gemver/gemver.c	LARGE_DATASET
durbin	linear-algebra/solvers/durbin	linear-algebra/solvers/durbin/durbin.c	LARGE_DATASET
gramschmidt	linear-algebra/solvers/gramschmidt	linear-algebra/solvers/gramschmidt/gramschmidt.c	LARGE_DATASET
trisolv	linear-algebra/solvers/trisolv	linear-algebra/solvers/trisolv/trisolv.c	LARGE_DATASET
ludcmp	linear-algebra/solvers/ludcmp	linear-algebra/solvers/ludcmp/ludcmp.c	LARGE_DATASET
lu	linear-algebra/solvers/lu	linear-algebra/solvers/lu/lu.c	LARGE_DATASET
cholesky	linear-algebra/solvers/cholesky	linear-algebra/solvers/cholesky/cholesky.c	LARGE_DATASET
heat-3d	stencils/heat-3d	stencils/heat-3d/heat-3d.c	LARGE_DATASET
jacobi-1d	stencils/jacobi-1d	stencils/jacobi-1d/jacobi-1d.c	LARGE_DATASET
adi	stencils/adi	stencils/adi/adi.c	LARGE_DATASET
seidel-2d	stencils/seidel-2d	stencils/seidel-2d/seidel-2d.c	LARGE_DATASET
jacobi-2d	stencils/jacobi-2d	stencils/jacobi-2d/jacobi-2d.c	LARGE_DATASET
fdtd-2d	stencils/fdtd-2d	stencils/fdtd-2d/fdtd-2d.c	LARGE_DATASET
covariance	datamining/covariance	datamining/covariance/covariance.c	LARGE_DATASET
correlation	datamining/correlation	datamining/correlation/correlation.c	LARGE_DATASET
